1111111111111
10G1000000001
1C00011111001
1P0E110000001
1111111111111