1111111111111
1GG100000G001
1C00011111001
1P0E110000001
1111111111111